W	W	W	W	W	W	W	W	W	W	W	W	W	W	W	W	W	W	W	W	W	W	W	W	W	W	W	W	W	W	W	W	W	W	W	W	W	W	W	W	W	W	W	W	W	W	W	W	W	W	W	W	W	W	W	W	W	W	W	W	W	W	W	W	W	W	W	W	W	W	W	W	W	W	W	W	W	W	W	W	W	W	W	W	W	W	W	W	W	W	W	W	W	W	W	W	W	W	W	W	W	W	W	W	W	W	W	W	W	W	W	W	W	W	W	W	W	W						
W	W	W	W	W	W	W	W	W	W	W	W	W	W	W	W	R	R	R	R	R	R	R	R	R	R	R	R	R	R	R	W	W	W	W	W	W	W	W	W	W	W	W	W	W	W	W	W	W	W	W	W	A	A	A	A	A	A	A	A	A	A	A	A	A	A	A	A	A	A	A	A	A	A	A	A	A	A	A	A	A	A	A	A	A	A	A	A	A	A	A	A	A	A	A	A	A	A	A	A	A	A	A	A	A	W	W	W	W	W	W	W	W	W	W	W	W	W						
W	W	W	W	W	W	W	W	W	R	R	R	R	R	R	R	G	G	G	G	G	G	G	G	G	G	G	G	G	G	G	R	R	W	W	W	W	W	W	W	W	W	W	W	W	W	W	W	W	W	W	W	B	B	B	B	B	B	B	B	B	B	B	B	B	B	B	B	B	B	B	B	B	B	B	B	B	B	B	B	B	B	B	B	B	B	B	B	B	B	B	B	B	B	B	B	B	B	B	B	B	B	B	B	A	A	W	W	W	W	W	W	W	W	W	W	W	W						
W	W	W	W	W	W	R	R	R	G	G	G	G	G	G	G	G	G	R	R	R	R	R	G	G	G	G	R	R	R	R	G	G	R	W	W	W	W	W	W	W	W	W	W	W	W	W	W	W	W	B	B	B	B	A	A	B	A	B	A	B	B	B	A	A	B	B	A	A	B	A	B	A	A	A	A	A	A	A	B	B	A	B	A	B	A	A	A	A	A	A	B	A	B	A	B	A	B	A	A	B	A	A	A	A	B	A	W	W	W	W	W	W	W	W	W	W	W						
W	W	W	W	W	R	G	G	G	G	G	G	G	G	G	G	G	R	G	G	G	G	G	R	G	G	R	G	G	G	G	R	G	G	R	B	B	B	W	W	W	W	W	W	W	W	W	B	B	B	B	B	B	B	B	B	B	B	B	B	B	B	B	B	B	B	B	B	B	B	B	B	B	B	B	B	B	B	B	B	B	B	B	B	B	B	B	B	B	B	B	B	B	B	B	B	B	B	B	B	B	B	B	B	B	B	A	W	W	W	W	W	W	W	W	W	W	W						
W	W	W	W	R	G	G	G	R	R	R	R	R	G	G	G	R	G	G	G	G	G	G	G	R	R	G	G	R	R	G	G	R	G	R	A	A	A	B	B	W	W	W	W	W	A	A	A	A	B	A	B	A	B	A	B	B	A	B	B	A	A	B	A	A	A	A	B	B	B	A	A	B	A	B	A	A	A	A	A	A	A	B	B	A	A	A	B	A	A	B	A	A	A	A	A	A	A	A	A	B	B	B	A	A	B	B	A	W	W	W	W	W	W	W	W	W	W						
W	W	W	W	R	G	G	R	G	G	G	G	G	R	G	R	G	G	G	R	R	R	G	G	G	R	G	R	G	G	R	G	R	G	G	R	B	B	B	B	B	B	W	B	B	B	B	B	B	B	B	B	B	B	B	B	B	B	B	B	B	B	B	B	B	B	B	B	B	B	B	B	B	B	B	B	B	B	B	B	B	B	B	B	B	B	B	B	B	B	B	B	B	B	B	B	B	B	B	B	B	B	B	B	B	B	B	A	W	W	W	W	W	W	W	W	W	W		Key	Meaning			
W	W	W	R	G	G	R	G	G	R	R	R	G	G	R	R	G	G	R	G	G	G	R	G	G	R	G	R	G	G	R	G	R	G	G	R	B	B	B	A	A	B	A	A	A	A	B	A	B	A	A	B	B	B	A	A	B	A	B	A	A	A	A	A	A	B	B	A	A	A	A	B	A	A	B	A	B	A	A	A	A	A	B	B	A	A	A	A	B	A	A	B	A	B	A	A	A	A	B	A	B	B	B	A	A	B	B	A	W	W	W	W	W	W	W	W	W	W		W	Water	Impassible		
W	W	W	R	G	R	G	G	R	G	G	G	R	G	G	R	G	G	R	G	R	G	R	G	G	R	G	G	R	R	G	G	R	G	G	R	B	B	B	B	B	B	B	B	B	B	B	B	B	B	B	B	B	B	B	B	B	B	B	B	B	B	B	B	B	B	B	B	B	B	B	B	B	B	B	B	B	B	B	B	B	B	B	B	B	B	B	B	B	B	B	B	B	B	B	B	B	B	B	B	B	B	B	B	B	B	B	A	W	W	W	W	W	W	W	W	W	W		R	Rock			
W	W	W	R	G	R	G	R	G	G	R	G	G	R	G	R	G	G	R	G	G	G	R	G	G	R	R	G	G	G	G	R	G	G	R	A	A	B	A	A	A	B	A	B	A	A	A	A	A	B	B	A	A	B	A	B	A	A	A	B	B	A	A	B	B	A	B	B	A	B	A	A	A	R	R	R	R	R	R	R	R	R	R	R	R	R	R	R	R	R	R	R	A	A	A	A	A	A	A	B	A	A	A	B	B	B	B	A	W	W	W	W	W	W	W	W	W	W		G	Thick Grass			
W	W	W	R	G	R	G	R	G	R	G	R	G	R	G	R	G	G	G	R	R	R	G	G	G	R	G	R	R	R	R	G	G	G	R	A	B	B	B	B	B	B	B	B	B	B	B	B	B	B	B	B	B	B	B	B	B	B	B	B	B	B	B	B	B	B	B	B	B	B	B	B	B	R	R	R	R	R	R	R	R	R	R	R	R	R	R	R	R	R	R	R	B	B	B	B	B	B	B	B	B	B	B	B	B	B	B	A	W	W	W	W	W	W	W	W	W	W		T	Trees			
W	W	R	G	G	R	G	R	G	G	R	G	G	R	G	R	R	G	G	G	G	G	G	G	R	G	G	G	G	G	G	G	G	R	A	A	B	A	A	B	A	B	A	B	A	A	A	B	A	A	B	A	B	B	A	A	B	B	A	A	A	B	A	A	B	B	B	A	B	B	A	A	A	R	R	R	R	v	v	v	v	v	v	v	v	v	v	v	R	R	R	R	A	A	A	B	B	A	B	A	B	A	A	A	B	A	A	A	W	W	W	W	W	W	W	W	W	W		B	Bog(Swamp)			
W	W	R	G	G	R	G	G	R	G	G	G	R	G	G	R	G	R	G	G	G	G	G	R	G	G	G	G	G	G	G	R	R	A	A	A	A	A	A	A	A	A	A	A	A	A	A	A	A	A	A	A	A	A	A	A	A	A	A	A	A	A	A	A	A	A	P	P	A	A	A	A	A	R	R	R	R	v	v	v	v	v	v	v	v	v	v	v	R	R	R	R	B	B	B	B	B	B	B	B	B	B	B	B	B	B	B	A	W	W	W	W	W	W	W	W	W	W		F	Forest			
W	W	R	G	G	G	R	G	G	R	R	R	G	G	R	G	G	G	R	R	R	R	R	G	G	G	R	R	R	R	R	T	T	T	T	T	T	T	T	T	T	T	T	T	T	T	T	T	T	T	T	T	T	T	T	T	T	T	T	T	T	T	T	T	T	T	P	P	T	T	T	T	T	R	R	R	R	v	v	v	v	v	v	v	v	v	v	v	R	R	R	R	A	A	A	A	A	A	A	B	B	A	A	A	B	A	B	A	W	W	W	W	W	W	W	W	W	W		G	Ground			
W	W	R	G	G	G	G	R	G	G	G	G	G	R	G	G	G	G	G	G	G	G	G	G	R	R	T	T	T	T	T	T	F	F	F	F	F	F	F	F	F	F	F	F	F	F	F	F	F	F	F	F	F	F	F	F	F	F	F	F	F	F	F	F	F	F	F	F	F	F	F	F	F	R	R	R	R	v	v	v	v	v	v	v	v	v	v	v	R	R	R	R	F	F	F	F	A	B	B	B	B	B	B	B	B	B	B	A	W	W	W	W	W	W	W	W	W	W		M	Marsh			
W	W	R	G	G	G	R	R	R	R	R	R	R	G	G	G	G	G	G	G	G	G	G	R	T	T	T	F	F	F	F	F	F	F	F	F	F	F	F	F	F	F	F	F	F	F	F	F	F	F	F	F	F	F	F	F	F	F	F	F	F	F	F	F	F	F	F	F	F	F	F	F	F	R	R	R	R	v	v	v	v	v	v	v	v	v	v	v	R	R	R	R	F	F	F	F	A	B	B	B	B	B	B	B	B	B	B	A	W	W	W	W	W	W	W	W	W	W		S	Sand			
W	W	R	G	G	R	G	G	G	G	R	G	G	G	G	G	G	G	G	G	R	R	R	T	T	F	F	F	F	F	F	F	F	F	F	F	F	F	F	F	F	F	F	F	F	F	F	F	F	F	F	F	F	F	F	F	F	F	F	F	F	F	F	F	F	F	F	F	F	F	F	F	F	R	R	R	R	v	v	v	v	v	v	v	v	v	v	v	R	R	R	R	F	F	F	F	A	B	B	B	B	B	B	B	B	B	B	A	W	W	W	W	W	W	W	W	W	W		P	Path			
W	W	R	G	R	G	G	R	R	G	G	R	G	G	G	G	G	G	G	R	T	T	T	T	F	F	F	F	F	F	F	F	F	F	F	F	F	F	F	F	F	F	F	F	F	F	F	F	F	F	F	F	F	F	F	F	F	F	F	F	F	F	F	F	F	F	F	F	F	F	F	F	F	R	R	R	R	v	v	v	v	v	v	v	v	v	v	v	R	R	R	R	F	F	F	F	A	B	B	B	B	B	B	B	B	B	B	A	W	W	W	W	W	W	W	W	W	W		Fi	Field Grass			
W	W	R	G	R	G	R	G	G	R	G	R	G	G	G	G	G	G	R	T	T	F	F	F	F	F	F	F	F	F	F	F	F	F	F	F	F	F	F	F	F	F	F	F	F	F	F	F	F	F	F	F	F	F	F	F	F	F	F	F	F	F	F	F	F	F	F	F	F	F	F	F	F	R	R	R	R	v	v	v	v	v	v	v	v	v	v	v	R	R	R	R	F	F	F	F	A	B	B	B	B	B	B	B	B	B	B	A	W	W	W	W	W	W	W	W	W	W			Stairs			
W	W	R	G	R	G	R	G	G	R	G	R	G	G	G	G	G	R	T	T	F	F	F	F	F	F	F	F	F	F	F	F	F	F	F	F	F	F	F	F	F	F	F	F	F	F	F	F	F	F	F	F	F	F	F	F	F	F	F	F	F	F	F	F	F	F	F	F	F	F	F	F	F	R	R	R	R	v	v	v	v	v	v	v	v	v	v	v	R	R	R	R	F	F	F	F	T	B	B	B	B	B	B	B	B	B	B	A	W	W	W	W	W	W	W	W	W	W						
W	W	R	G	R	G	G	R	R	G	G	R	G	G	G	G	R	T	T	F	F	F	F	F	F	F	F	F	F	F	F	F	F	F	F	F	F	F	F	F	F	F	F	F	F	F	F	F	F	F	F	F	F	F	F	F	F	F	F	F	F	F	F	F	F	F	F	F	F	F	F	F	F	R	R	R	R	v	v	v	v	v	v	v	v	v	v	v	R	R	R	R	F	F	F	F	T	B	B	B	B	B	B	B	B	B	B	A	W	W	W	W	W	W	W	W	W	W						
W	W	R	G	G	R	G	G	G	G	R	G	G	G	G	R	T	T	F	F	F	F	F	F	F	F	F	F	F	F	F	F	F	F	F	F	F	F	F	F	F	F	F	F	F	F	F	F	F	F	F	F	F	F	F	F	F	F	F	F	F	F	F	F	F	F	F	F	F	F	F	F	F	R	R	R	R	v	v	v	v	v	v	v	v	v	v	v	R	R	R	R	F	F	F	F	T	B	B	B	B	B	B	B	B	B	B	A	W	W	W	W	W	W	W	W	W	W						
W	W	R	G	G	G	R	R	R	R	G	G	G	G	G	R	T	F	F	F	F	F	F	F	F	F	F	F	F	F	F	F	F	F	F	F	F	F	F	F	F	F	F	F	F	F	F	F	F	F	F	F	F	F	F	F	F	F	F	F	F	F	F	F	F	F	F	F	F	F	F	F	F	R	R	R	R	v	v	v	v	v	v	v	v	v	v	v	R	R	R	R	F	F	F	F	T	B	B	B	B	B	B	B	B	B	B	A	W	W	W	W	W	W	W	W	W	W						
W	W	R	G	G	G	G	G	G	G	G	G	G	G	R	T	T	F	F	F	F	F	F	F	F	F	F	F	F	F	F	F	F	F	F	F	F	F	F	F	F	F	F	F	F	F	F	F	F	F	F	F	F	F	F	F	F	F	F	F	F	F	F	F	F	F	F	F	F	F	F	F	F	R	R	R	R	R	R	R	R	s	s	s	R	R	R	R	R	R	R	R	F	F	F	F	T	B	B	B	B	B	B	B	B	B	B	A	W	W	W	W	W	W	W	W	W	W						
W	W	R	G	G	G	o	o	o	G	R	P	R	G	R	T	F	F	F	F	F	F	F	F	F	F	F	F	F	F	F	F	F	F	F	F	F	F	F	F	F	F	F	F	F	F	F	F	F	F	F	F	F	F	F	F	F	F	F	F	F	F	F	F	F	F	F	F	F	F	F	F	F	R	R	R	R	R	R	R	R	s	s	s	R	R	R	R	R	R	R	R	F	F	F	F	T	B	B	B	B	B	B	B	B	B	B	A	W	W	W	W	W	W	W	W	W	W						
W	R	R	R	R	o	o	o	o	o	R	P	R	R	T	T	F	F	F	F	F	F	F	F	F	F	F	F	F	F	F	F	F	F	F	F	F	F	F	F	F	F	F	F	F	F	F	F	F	F	F	F	F	F	F	F	F	F	F	F	F	F	F	F	F	F	F	F	F	F	F	F	F	R	R	R	R	R	R	R	R	s	s	s	R	R	R	R	R	R	R	R	F	F	F	F	T	B	B	B	B	B	B	B	B	B	B	A	W	W	W	W	W	W	W	W	W	W						
W	R	G	G	G	o	o	o	o	o	G	G	G	R	T	F	F	F	F	F	F	F	F	F	F	F	F	F	F	F	F	F	F	F	F	F	F	F	F	F	F	F	F	F	F	F	F	F	F	F	F	F	F	F	F	F	F	F	F	F	F	F	F	F	F	F	F	F	F	F	F	F	F	R	R	R	R	R	R	R	R	s	s	s	R	R	R	R	R	R	R	R	F	F	F	F	T	B	B	B	B	B	B	B	B	B	B	A	W	W	W	W	W	W	W	W	W	W						
W	R	G	G	G	o	o	o	o	o	G	G	G	R	T	F	F	F	F	F	F	F	F	F	F	F	F	F	F	F	F	F	F	F	F	F	F	F	F	F	F	F	F	F	F	F	F	F	F	F	F	F	F	F	F	F	F	F	F	F	F	F	F	F	F	F	F	F	F	F	F	F	F	R	R	R	R	R	R	R	R	s	s	s	R	R	R	R	R	R	R	R	F	F	F	F	T	B	B	B	B	B	B	B	B	B	B	A	W	W	W	W	W	W	W	W	W	W						
W	R	G	G	G	o	o	o	o	o	G	G	G	R	T	F	F	F	F	F	F	F	F	F	F	F	F	F	F	F	F	F	F	F	F	F	F	F	F	F	F	F	F	F	F	F	F	F	F	F	F	F	F	F	F	F	F	F	F	F	F	F	F	F	F	F	F	F	F	F	F	F	F	R	R	R	R	R	R	R	R	s	s	s	R	R	R	R	R	R	R	R	F	F	F	F	T	B	B	B	B	B	B	B	B	B	B	A	W	W	W	W	W	W	W	W	W	W						
W	R	G	G	G	o	o	o	o	o	G	G	G	R	X	X	X	X	X	X	X	X	X	X	X	X	X	X	X	X	X	X	X	X	X	X	X	X	X	X	X	X	X	X	X	X	X	X	X	X	X	X	X	X	X	X	X	X	X	X	F	F	F	F	F	F	F	F	F	F	F	F	F	F	F	F	F	F	F	F	F	F	F	F	F	F	F	F	F	F	F	F	F	F	F	F	T	B	B	B	B	B	B	B	B	B	B	A	W	W	W	W	W	W	W	W	W	W						
W	R	G	G	G	o	o	o	o	o	G	G	G	R	X	X	X	X	X	X	X	X	X	X	X	X	X	X	X	X	X	X	X	X	X	X	X	X	X	X	X	X	X	X	X	X	X	X	X	X	X	X	X	X	X	X	X	X	X	X	F	F	F	F	F	F	F	F	F	F	F	F	F	F	F	F	F	F	F	F	F	F	F	F	F	F	F	F	F	F	F	F	F	F	F	F	T	B	B	B	B	B	B	B	B	B	B	A	W	W	W	W	W	W	W	W	W	W						
W	R	G	G	G	o	o	o	o	o	G	G	G	R	X	X	X	X	X	X	X	X	X	X	X	X	X	X	X	X	X	X	m	m	m	m	m	m	m	m	m	m	m	m	m	m	m	m	m	m	m	m	m	m	m	m	m	m	X	X	F	F	F	F	F	F	F	F	F	F	F	F	F	F	F	F	F	F	F	F	F	F	F	F	F	F	F	F	F	F	F	F	F	F	F	F	T	A	A	A	A	A	A	A	A	A	A	A	W	W	W	W	W	W	W	W	W	W						
W	R	G	G	G	G	G	G	G	G	G	G	G	R	X	X	g	g	g	g	g	g	g	g	g	g	g	X	X	X	X	X	m	m	m	m	m	m	m	m	m	m	m	m	m	m	m	m	m	m	m	m	m	m	m	m	m	m	X	X	F	F	F	F	F	F	F	F	F	F	F	F	F	F	F	F	F	F	F	F	F	F	F	F	F	F	F	F	F	F	F	F	F	F	F	F	T	M	M	M	M	M	M	M	M	M	M	M	W	W	W	W	W	W	W	W	W	W						
W	R	G	G	G	G	G	G	G	G	G	G	G	R	X	P	g	g	g	g	g	g	g	g	g	g	g	X	X	X	X	X	m	m	m	m	m	m	m	m	m	m	m	m	m	m	m	m	m	m	m	m	m	m	m	m	m	m	X	X	F	F	F	F	F	F	F	F	F	F	F	F	F	F	F	F	F	F	F	F	F	F	F	F	F	F	F	F	F	F	F	F	F	F	F	F	T	M	W	W	W	W	W	W	W	W	W	W	W	W	W	W	W	W	W	W	W	W						
W	R	G	G	G	G	G	G	G	G	G	G	G	S	P	P	g	g	g	g	g	g	g	g	g	g	g	X	X	X	X	X	m	m	m	m	m	m	m	m	m	m	m	m	m	m	m	m	m	m	m	m	m	m	m	m	m	m	X	X	F	F	F	F	F	F	F	F	F	F	F	F	F	F	F	F	F	F	F	F	F	F	F	F	F	F	F	F	F	F	F	F	F	F	F	F	T	M	M	M	M	M	M	W	M	M	M	M	W	W	W	W	W	W	W	W	W	W						
W	R	G	G	G	G	G	G	G	G	G	G	G	S	P	P	g	g	g	g	g	g	g	g	g	g	g	X	X	X	X	X	m	m	m	m	m	m	m	m	m	m	m	m	m	m	m	m	m	m	m	m	m	m	m	m	m	m	X	X	F	F	F	F	F	F	F	F	F	F	F	F	F	F	F	F	F	F	F	F	F	F	F	F	F	F	F	F	F	F	F	F	F	F	F	F	T	M	W	W	W	W	W	W	M	M	M	M	W	W	W	W	W	W	W	W	W	W						
W	R	G	G	G	G	G	G	G	G	G	G	G	R	X	P	g	g	g	g	g	g	g	g	g	g	g	X	X	X	X	X	m	m	m	m	m	m	m	m	m	m	X	X	X	X	X	X	X	X	X	X	X	X	X	X	X	X	X	X	F	F	F	F	F	F	F	F	F	F	F	F	F	F	F	F	F	F	F	F	F	F	F	F	F	F	F	F	F	F	F	F	F	F	F	F	T	M	M	M	M	W	M	M	M	M	M	M	W	W	W	W	W	W	W	W	W	W						
W	R	G	G	G	G	G	G	G	G	G	G	G	R	X	X	g	g	g	g	g	g	g	g	g	g	g	X	X	X	X	X	m	m	m	m	m	m	m	m	m	m	X	X	w	w	w	w	w	w	w	w	w	w	w	w	w	w	X	X	F	F	F	F	F	F	F	F	F	F	F	F	F	F	F	F	F	F	F	F	F	F	F	F	F	F	F	F	F	F	F	F	F	F	F	F	T	M	M	M	M	W	W	W	M	M	M	M	W	W	W	W	W	W	W	W	W	W						
W	R	G	G	G	G	G	G	W	W	W	W	G	R	X	X	g	g	g	g	g	g	g	g	g	g	g	X	X	X	X	X	m	m	m	m	m	m	m	m	m	m	X	X	w	w	w	w	w	w	w	w	w	w	w	w	w	w	X	X	F	F	F	F	F	F	F	F	F	F	F	F	F	F	F	F	F	F	F	F	F	F	F	F	F	F	F	F	F	F	F	F	F	F	F	F	T	M	M	W	W	W	M	M	M	M	M	M	W	W	W	W	W	W	W	W	W	W						
W	R	G	G	G	G	G	G	W	W	W	W	W	W	W	W	g	g	g	g	g	g	g	g	g	g	g	X	X	X	X	X	m	m	m	m	m	m	m	m	m	m	X	X	w	w	w	w	w	w	w	w	w	w	w	w	w	w	X	X	F	F	F	F	F	F	F	F	F	F	F	F	F	F	F	F	F	F	F	F	F	F	F	F	F	F	F	F	F	F	F	F	F	F	F	F	T	M	M	M	M	W	M	M	M	M	M	M	W	W	W	W	W	W	W	W	W	W						
W	R	G	G	G	G	G	G	W	W	W	W	W	W	W	W	g	g	g	g	g	g	g	g	g	g	g	X	X	X	X	X	m	m	m	m	m	m	m	m	m	m	X	X	w	w	w	w	w	w	w	w	w	w	w	w	w	w	X	X	F	F	F	F	F	F	F	F	F	F	F	F	F	F	F	F	F	F	F	F	F	F	F	F	F	F	F	F	F	F	F	F	F	F	F	F	T	M	M	M	M	M	M	M	M	M	M	M	W	W	W	W	W	W	W	W	W	W						
W	R	G	G	G	G	G	G	W	W	W	W	G	R	X	X	g	g	g	g	g	g	g	g	g	g	g	X	X	X	X	X	m	m	m	m	m	m	m	m	m	m	X	X	w	w	w	w	w	w	w	w	w	w	w	w	w	w	X	X	F	F	F	F	F	F	F	F	F	F	F	F	F	F	F	F	F	F	F	F	F	F	F	F	F	F	F	F	F	F	F	F	F	F	F	F	T	M	M	M	M	M	W	W	W	W	W	W	W	W	W	W	W	W	W	W	W	W						
W	R	G	G	G	G	G	G	G	G	G	G	G	R	X	X	g	g	g	g	g	g	g	g	g	g	g	P	X	X	X	X	m	m	m	m	m	m	m	m	m	m	X	X	w	w	w	w	w	w	w	w	w	w	w	w	w	w	X	X	F	F	F	F	F	F	F	F	F	F	F	F	F	F	F	F	F	F	F	F	F	F	F	F	F	F	F	F	F	F	F	F	F	F	F	F	T	M	M	M	M	M	M	M	M	W	M	M	W	W	W	W	W	W	W	W	W	W						
W	R	G	G	G	G	G	G	G	G	G	G	G	R	X	X	X	X	X	X	X	X	X	X	X	X	P	P	P	X	X	X	m	m	m	m	m	m	m	m	m	m	X	X	w	w	w	w	w	w	w	w	w	w	w	w	w	w	X	X	F	F	F	F	F	F	F	F	F	F	F	F	F	F	F	F	F	F	F	F	F	F	F	F	F	F	F	F	F	F	F	F	F	F	F	F	T	M	M	M	M	M	M	M	M	W	M	M	W	W	W	W	W	W	W	W	W	W						
W	R	G	G	G	G	G	G	G	G	G	G	G	R	X	X	X	X	X	X	X	X	X	X	X	X	X	P	P	P	X	X	X	X	X	X	P	X	X	X	X	X	X	P	w	w	w	w	w	w	w	w	w	w	w	w	w	w	X	X	F	F	F	F	F	F	F	F	F	F	F	F	F	F	F	F	F	F	F	F	F	F	F	F	F	F	F	F	F	F	F	F	F	F	F	F	T	M	M	M	W	M	M	M	M	W	M	M	W	W	W	W	W	W	W	W	W	W						
W	R	G	G	G	G	G	G	G	G	G	G	G	R	X	X	X	X	X	X	X	X	X	X	X	X	X	X	P	P	P	X	X	X	X	X	P	X	X	X	X	X	P	P	P	X	X	X	X	X	X	X	X	X	X	X	X	X	X	X	F	F	F	F	F	F	F	F	F	F	F	F	F	F	F	F	F	F	F	F	F	F	F	F	F	F	F	F	F	F	F	F	F	F	F	F	T	M	M	M	W	M	M	M	M	M	M	M	W	W	W	W	W	W	W	W	W	W						
W	R	G	G	G	G	G	G	G	G	G	G	G	R	X	X	X	X	X	X	X	X	X	X	X	X	X	X	X	P	P	P	X	X	X	X	P	X	X	X	X	P	P	P	X	X	X	X	X	X	X	X	X	X	X	X	X	X	X	X	F	F	F	F	F	F	F	F	F	F	F	F	F	F	F	F	F	F	F	F	F	F	F	F	F	F	F	F	F	F	F	F	F	F	F	F	T	M	M	M	W	M	M	M	M	M	M	M	W	W	W	W	W	W	W	W	W	W						
W	R	G	G	G	G	G	G	G	G	G	G	G	R	X	X	X	X	X	X	X	X	X	X	X	X	X	X	X	X	P	P	P	X	X	X	P	X	X	X	P	P	P	X	X	X	X	X	X	X	X	X	X	X	X	X	X	X	X	X	F	F	F	F	F	F	F	F	F	F	F	F	F	F	F	F	F	F	F	F	F	F	F	F	F	F	F	F	F	F	F	F	F	F	F	F	T	M	M	W	W	W	W	W	W	W	W	W	W	W	W	W	W	W	W	W	W	W						
W	R	G	G	G	G	G	G	G	G	G	G	G	R	X	X	X	X	X	X	X	X	X	X	X	X	X	X	X	X	X	P	P	P	X	X	P	X	X	P	P	P	X	X	X	X	X	X	X	X	X	X	X	X	X	X	X	X	X	X	F	F	F	F	F	F	F	F	F	F	F	F	F	F	F	F	F	F	F	F	F	F	F	F	F	F	F	F	F	F	F	F	F	F	F	F	T	M	M	M	M	M	W	M	M	M	M	M	W	W	W	W	W	W	W	W	W	W						
W	R	G	G	G	G	G	G	G	G	G	G	G	R	X	X	X	X	X	X	X	X	X	X	X	X	X	X	X	X	X	X	P	P	P	P	P	P	P	P	P	X	X	X	X	X	X	X	X	X	X	X	X	X	X	X	X	X	X	X	F	F	F	F	F	F	F	F	F	F	F	F	F	F	F	F	F	F	F	F	F	F	F	F	F	F	F	F	F	F	F	F	F	F	F	F	T	M	M	M	M	M	W	M	M	M	M	M	W	W	W	W	W	W	W	W	W	W						
W	R	G	G	G	G	G	G	G	G	G	G	G	R	X	X	X	X	X	X	X	X	X	X	X	X	X	X	X	X	X	X	X	P	X	X	X	X	X	P	X	X	X	X	X	X	X	X	X	X	X	X	X	X	X	X	X	X	X	X	F	F	F	F	F	F	F	F	F	F	F	F	F	F	F	F	F	F	F	F	F	F	F	F	F	F	F	F	F	F	F	F	F	F	F	F	T	M	M	M	M	M	W	M	M	M	M	M	W	W	W	W	W	W	W	W	W	W						
W	R	G	G	G	G	G	G	G	G	G	G	G	R	X	X	X	X	X	X	X	X	X	X	X	X	X	X	X	X	X	X	X	P	X	X	X	X	X	P	P	P	P	P	X	X	X	X	X	X	X	X	X	X	X	X	X	X	X	X	F	F	F	F	F	F	F	F	F	F	F	F	F	F	F	F	F	F	F	F	F	F	F	F	F	F	F	F	F	F	F	F	F	F	F	F	T	M	M	W	M	M	W	M	M	M	M	M	W	W	W	W	W	W	W	W	W	W						
W	R	G	G	G	G	G	G	G	G	G	G	G	R	X	X	X	X	X	X	X	X	X	X	X	X	X	X	X	X	X	X	X	P	X	X	X	X	X	P	P	P	P	P	X	X	X	X	X	X	X	X	X	X	X	X	X	X	X	X	F	F	F	F	F	F	F	F	F	F	F	F	F	F	F	F	F	F	F	F	F	F	F	F	F	F	F	F	F	F	F	F	F	F	F	F	T	M	M	W	M	M	M	M	M	M	M	M	W	W	W	W	W	W	W	W	W	W						
W	R	G	G	G	G	G	G	G	G	G	G	G	R	X	X	X	X	X	X	X	X	X	X	X	X	X	X	X	X	X	X	X	P	X	X	X	X	X	P	P	P	P	P	X	X	X	X	X	X	X	X	X	X	X	X	X	X	X	X	F	F	F	F	F	F	F	F	F	F	F	F	F	F	F	F	F	F	F	F	F	F	F	F	F	F	F	F	F	F	F	F	F	F	F	F	T	M	M	W	M	M	M	M	M	M	M	M	W	W	W	W	W	W	W	W	W	W						
W	R	G	G	G	G	G	G	G	G	G	G	G	R	X	X	X	X	X	X	X	X	X	X	X	X	X	X	X	X	X	X	X	P	X	X	X	X	X	P	X	X	X	X	X	X	X	X	X	X	X	X	X	X	X	X	X	X	X	X	F	F	F	F	F	F	F	F	F	F	F	F	F	F	F	F	F	F	F	F	F	F	F	F	F	F	F	F	F	F	F	F	F	F	F	F	T	M	M	W	W	W	W	W	W	W	W	W	W	W	W	W	W	W	W	W	W	W						
W	R	G	G	G	G	G	G	G	G	G	G	G	R	X	X	X	X	X	X	X	X	X	X	X	X	X	X	X	X	X	X	X	P	P	P	P	P	P	P	P	X	X	X	X	X	X	X	X	X	X	X	X	X	X	X	X	X	X	X	F	F	F	F	F	F	F	F	F	F	F	F	F	F	F	F	F	F	F	F	F	F	F	F	F	F	F	F	F	F	F	F	F	F	F	F	T	M	M	M	M	M	M	M	W	M	M	M	W	W	W	W	W	W	W	W	W	W						
W	R	G	G	G	G	G	G	G	G	G	G	G	R	X	X	X	X	X	X	X	X	X	X	X	X	X	X	X	X	X	X	X	X	X	X	P	X	X	P	P	P	X	X	X	X	X	X	X	X	X	X	X	X	X	X	X	X	X	X	F	F	F	F	F	F	F	F	F	F	F	F	F	F	F	F	F	F	F	F	F	F	F	F	F	F	F	F	F	F	F	F	F	F	F	F	T	M	M	M	W	M	M	M	W	M	M	M	W	W	W	W	W	W	W	W	W	W						
W	R	G	G	G	G	G	G	G	G	G	G	G	R	X	X	X	X	X	X	X	X	X	X	X	X	X	X	X	X	X	X	X	X	X	X	P	X	X	X	P	P	P	X	X	X	X	X	X	X	X	X	X	X	X	X	X	X	X	X	F	F	F	F	F	F	F	F	F	F	F	F	F	F	F	F	F	F	F	F	F	F	F	F	F	F	F	F	F	F	F	F	F	F	F	F	T	M	W	W	W	M	M	M	W	M	M	M	W	W	W	W	W	W	W	W	W	W						
W	R	G	G	G	G	G	G	G	G	G	G	G	R	X	X	X	X	X	X	X	X	X	X	X	X	X	X	X	X	X	X	X	X	X	X	P	X	X	X	X	P	P	P	X	X	X	X	X	X	X	X	X	X	X	X	X	X	X	X	F	F	F	F	F	F	F	F	F	F	F	F	F	F	F	F	F	F	F	F	F	F	F	F	F	F	F	F	F	F	F	F	F	F	F	F	T	M	M	M	W	M	M	M	W	M	M	M	W	W	W	W	W	W	W	W	W	W						
W	R	G	G	G	G	G	G	G	G	G	G	G	R	X	X	X	X	X	X	X	X	X	X	X	X	X	X	X	X	X	X	X	X	X	X	P	X	X	X	X	X	P	P	P	X	X	X	X	X	X	X	X	X	X	X	X	X	X	X	F	F	F	F	F	F	F	F	F	F	F	F	F	F	F	F	F	F	F	F	F	F	F	F	F	F	F	F	F	F	F	F	F	F	F	F	T	M	M	W	W	W	W	W	W	M	M	M	W	W	W	W	W	W	W	W	W	W						
W	R	G	G	G	G	G	G	G	G	G	G	G	R	X	X	X	X	X	X	X	X	X	X	X	X	X	X	X	X	X	X	X	X	X	X	P	X	X	X	X	X	X	P	P	P	P	t	t	t	t	t	t	t	t	t	t	t	X	X	F	F	F	F	F	F	F	F	F	F	F	F	F	F	F	F	F	F	F	F	F	F	F	F	F	F	F	F	F	F	F	F	F	F	F	F	T	M	M	M	M	M	M	M	W	M	W	W	W	W	W	W	W	W	W	W	W	W						
W	R	G	G	G	G	G	G	G	G	G	G	G	R	X	X	X	X	X	X	X	X	X	X	X	X	X	X	X	X	X	n	n	n	n	n	n	n	n	n	n	n	X	X	P	P	P	t	t	t	t	t	t	t	t	t	t	t	X	X	F	F	F	F	F	F	F	F	F	F	F	F	F	F	F	F	F	F	F	F	F	F	F	F	F	F	F	F	F	F	F	F	F	F	F	F	T	M	M	M	M	M	M	M	W	M	M	M	W	W	W	W	W	W	W	W	W	W						
W	R	G	G	G	G	G	G	G	G	G	G	G	R	X	X	X	s	s	s	s	s	s	s	s	X	X	X	X	X	X	n	n	n	n	n	n	n	n	n	n	n	X	X	P	P	t	t	t	t	t	t	t	t	t	t	t	t	X	X	F	F	F	F	F	F	F	F	F	F	F	F	F	F	F	F	F	F	F	F	F	F	F	F	F	F	F	F	F	F	F	F	F	F	F	F	T	M	M	M	M	M	M	M	W	M	M	M	W	W	W	W	W	W	W	W	W	W						
W	R	G	G	G	G	G	G	G	G	G	G	G	R	X	X	X	s	s	s	s	s	s	s	s	X	X	X	X	X	X	n	n	n	n	n	n	n	n	n	n	n	X	X	t	t	t	t	t	t	t	t	t	t	t	t	t	t	X	X	F	F	F	F	F	F	F	F	F	F	F	F	F	F	F	F	F	F	F	F	F	F	F	F	F	F	F	F	F	F	F	F	F	F	F	F	T	M	M	M	M	M	M	M	W	M	M	M	W	W	W	W	W	W	W	W	W	W						
W	R	G	G	G	G	G	G	G	G	G	G	G	R	X	X	X	s	s	s	s	s	s	s	s	X	X	X	X	X	X	n	n	n	n	n	n	n	n	n	n	n	X	X	t	t	t	t	t	t	t	t	t	t	t	t	t	t	X	X	F	F	F	F	F	F	F	F	F	F	F	F	F	F	F	F	F	F	F	F	F	F	F	F	F	F	F	F	F	F	F	F	F	F	F	F	T	M	M	W	W	W	W	W	W	M	M	M	W	W	W	W	W	W	W	W	W	W						
W	R	G	G	G	G	G	G	G	G	G	G	G	R	X	X	X	s	s	s	s	s	s	s	s	X	X	X	X	X	X	n	n	n	n	n	n	n	n	n	n	n	X	X	t	t	t	t	t	t	t	t	t	t	t	t	t	X	X	X	F	F	F	F	F	F	F	F	F	F	F	F	F	F	F	F	F	F	F	F	F	F	F	F	F	F	F	F	F	F	F	F	F	F	F	F	T	M	M	M	M	M	M	M	W	M	M	M	W	W	W	W	W	W	W	W	W	W						
W	R	G	G	G	G	G	G	G	G	G	G	G	R	X	X	X	s	s	s	s	s	s	s	s	X	X	X	X	X	X	n	n	n	n	n	n	n	n	n	n	n	X	X	t	t	t	t	t	t	t	t	t	t	t	t	t	X	X	X	F	F	F	F	F	F	F	F	F	F	F	F	F	F	F	F	F	F	F	F	F	F	F	F	F	F	F	F	F	F	F	F	F	F	F	F	T	M	M	M	M	M	M	M	M	M	M	M	W	W	W	W	W	W	W	W	W	W						
W	R	G	G	G	G	G	G	G	G	G	G	G	R	X	X	X	s	s	s	s	s	s	s	s	X	X	X	X	X	X	n	n	n	n	n	n	n	n	n	n	n	X	X	t	t	t	t	t	t	t	t	t	t	t	t	t	X	X	X	F	F	F	F	F	F	F	F	F	F	F	F	F	F	F	F	F	F	F	F	F	F	F	F	F	F	F	F	F	F	F	F	F	F	F	F	T	M	M	M	M	M	W	M	M	M	M	M	W	W	W	W	W	W	W	W	W	W						
W	R	G	G	G	G	G	G	G	G	G	G	G	R	X	X	X	s	s	s	s	s	s	s	s	X	X	X	X	X	X	n	n	n	n	n	n	n	n	n	n	n	X	X	t	t	t	t	t	t	t	t	t	t	t	t	X	X	X	X	F	F	F	F	F	F	F	F	F	F	F	F	F	F	F	F	F	F	F	F	F	F	F	F	F	F	F	F	F	F	F	F	F	F	F	F	T	M	M	M	W	W	W	M	M	M	M	M	W	W	W	W	W	W	W	W	W	W						
W	R	G	G	G	G	G	G	G	G	G	G	G	R	X	X	X	s	s	s	s	s	s	s	s	X	X	X	X	X	X	n	n	n	n	n	n	n	n	n	n	n	X	X	t	t	t	t	t	t	t	t	t	t	t	t	X	X	X	X	F	F	F	F	F	F	F	F	F	F	F	F	F	F	F	F	F	F	F	F	F	F	F	F	F	F	F	F	F	F	F	F	F	F	F	F	T	M	M	M	M	M	W	W	W	W	W	W	W	W	W	W	W	W	W	W	W	W						
W	R	G	G	G	G	G	G	G	G	G	G	G	R	X	X	X	s	s	s	s	s	s	s	s	X	X	X	X	X	X	n	n	n	n	n	n	n	n	n	n	n	X	X	t	t	t	t	t	t	t	t	t	t	t	X	X	X	X	X	F	F	F	F	F	F	F	F	F	F	F	F	F	F	F	F	F	F	F	F	F	F	F	F	F	F	F	F	F	F	F	F	F	F	F	F	T	M	M	M	M	M	M	M	W	M	M	M	W	W	W	W	W	W	W	W	W	W						
W	R	G	G	G	G	G	G	G	G	G	G	G	R	X	X	X	s	s	s	s	s	s	s	s	X	X	X	X	X	X	n	n	n	n	n	n	n	n	n	n	n	X	X	t	t	t	t	t	t	t	t	t	t	X	X	X	X	X	X	F	F	F	F	F	F	F	F	F	F	F	F	F	F	F	F	F	F	F	F	F	F	F	F	F	F	F	F	F	F	F	F	F	F	F	F	T	M	M	M	M	M	M	M	W	M	M	M	W	W	W	W	W	W	W	W	W	W						
W	R	R	R	G	G	G	G	G	G	G	G	G	R	X	X	X	s	s	s	s	s	s	s	s	X	X	X	X	X	X	X	X	X	X	X	X	X	X	X	X	X	X	X	t	t	t	t	t	t	t	t	X	X	X	X	X	X	X	X	F	F	F	F	F	F	F	F	F	F	F	F	F	F	F	F	F	F	F	F	F	F	F	F	F	F	F	F	F	F	F	F	F	F	F	T	T	M	M	M	M	M	M	M	W	M	M	M	W	W	W	W	W	W	W	W	W	W						
W	W	W	W	R	R	R	G	G	G	G	G	G	R	X	X	X	s	s	s	s	s	s	s	s	X	X	X	X	X	X	X	X	X	X	X	X	X	X	X	X	X	X	X	t	t	t	t	t	X	X	X	X	X	X	X	X	X	X	X	F	F	F	F	F	F	F	F	F	F	F	F	F	F	F	F	F	F	F	F	F	F	F	F	F	F	F	F	F	F	F	F	F	F	F	T	S	M	M	M	M	M	M	M	W	M	M	M	W	W	W	W	W	W	W	W	W	W						
W	W	W	W	W	W	W	R	R	G	G	G	G	R	X	X	X	X	X	X	X	X	X	X	X	X	X	X	X	X	X	X	X	X	X	X	X	X	X	X	X	X	X	X	X	X	X	X	X	X	X	X	X	X	X	X	X	X	X	X	F	F	F	F	F	F	F	F	F	F	F	F	F	F	F	F	F	F	F	F	F	F	F	F	F	F	F	F	F	F	F	F	F	F	F	T	S	S	M	M	M	M	M	M	W	M	M	M	W	W	W	W	W	W	W	W	W	W						
W	W	W	W	W	W	W	W	W	R	G	G	G	R	S	S	S	S	S	S	S	S	S	S	S	S	S	S	S	S	S	S	S	S	S	S	S	S	X	X	X	X	X	X	X	X	X	X	X	X	X	X	X	X	X	X	X	X	X	X	F	F	F	F	F	F	F	F	F	F	F	F	F	F	F	F	F	F	F	F	F	F	F	F	F	F	F	F	F	F	F	F	F	F	T	T	S	S	S	M	M	M	M	M	M	M	M	M	W	W	W	W	W	W	W	W	W	W						
W	W	W	W	W	W	W	W	W	W	R	G	G	R	S	S	S	S	S	S	S	S	S	S	S	S	S	S	S	S	S	S	S	S	S	S	S	S	T	T	F	F	F	F	F	F	F	F	F	F	F	F	F	F	F	F	F	F	F	F	F	F	F	F	F	F	F	F	F	F	F	F	F	F	F	F	F	F	F	F	F	F	F	F	F	F	F	F	F	F	F	F	T	T	T	S	S	S	S	S	M	M	M	M	M	M	M	M	W	W	W	W	W	W	W	W	W	W						
W	W	W	W	W	W	W	W	W	W	W	R	G	R	S	S	S	S	S	S	S	S	S	S	S	S	S	S	S	S	S	S	S	S	S	S	S	S	S	T	T	T	F	F	F	F	F	F	F	F	F	F	F	F	F	F	F	F	F	F	F	F	F	F	F	F	F	F	F	F	F	F	F	F	F	F	F	F	F	F	F	F	F	F	F	F	F	F	F	F	T	T	T	S	S	S	S	S	S	S	S	M	M	M	M	M	M	M	W	W	W	W	W	W	W	W	W	W						
W	W	W	W	W	W	W	W	W	W	W	R	G	R	S	S	S	S	S	S	S	S	S	S	S	S	S	S	S	S	S	S	S	S	S	S	S	S	S	S	S	T	T	T	T	F	F	F	F	F	F	F	F	F	F	F	F	F	F	F	F	F	F	F	F	F	F	F	F	F	F	F	F	F	F	F	F	F	F	F	F	F	F	F	F	F	F	T	T	T	T	S	S	S	S	S	S	S	S	S	S	S	M	M	M	M	M	M	W	W	W	W	W	W	W	W	W	W						
W	W	W	W	W	W	W	W	W	W	W	W	R	S	S	S	S	S	S	S	S	S	S	S	S	S	S	S	S	S	S	S	S	S	S	S	S	S	S	S	S	S	S	S	T	T	T	T	T	T	T	T	T	T	T	T	T	T	T	T	T	T	T	T	T	T	T	T	F	T	F	F	F	T	T	T	T	T	T	T	T	T	T	T	T	T	T	T	S	S	S	S	S	S	S	S	S	S	S	S	S	S	S	M	M	M	M	M	W	W	W	W	W	W	W	W	W	W						
W	W	W	W	W	W	W	W	W	W	W	W	S	S	S	S	S	S	S	S	S	S	S	S	S	S	S	S	S	S	S	S	S	S	S	S	S	S	S	S	S	S	S	S	S	S	S	S	S	S	S	S	S	S	S	S	S	S	S	S	S	S	S	S	S	S	S	S	S	S	S	S	S	S	S	S	S	S	S	S	S	S	S	S	S	S	S	S	S	S	S	S	S	S	S	S	S	S	S	S	S	S	S	S	M	M	M	M	W	W	W	W	W	W	W	W	W	W						
W	W	W	W	W	W	W	W	W	W	W	W	S	S	S	S	S	S	S	S	S	S	S	S	S	S	S	S	S	S	S	S	S	S	S	S	S	S	S	S	S	S	S	S	S	S	S	S	S	S	S	S	S	S	S	S	S	S	S	S	S	S	S	S	S	S	S	S	S	S	S	S	S	S	S	S	S	S	S	S	S	S	S	S	S	S	S	S	S	S	S	S	S	S	S	S	S	S	S	S	S	S	S	S	S	M	M	M	W	W	W	W	W	W	W	W	W	W						
W	W	W	W	W	W	W	W	W	W	W	W	W	S	S	S	S	S	S	S	S	S	S	S	S	S	S	S	S	S	S	S	S	S	S	S	S	S	S	S	S	S	S	S	S	S	S	S	S	S	S	S	S	S	S	S	S	S	S	S	S	S	S	S	S	S	S	S	S	S	S	S	S	S	S	S	S	S	S	S	S	S	S	S	S	S	S	S	S	S	S	S	S	S	S	S	S	S	S	S	S	S	S	S	S	S	M	M	W	W	W	W	W	W	W	W	W	W						
W	W	W	W	W	W	W	W	W	W	W	W	W	S	S	S	S	S	S	S	S	S	S	S	S	S	S	S	S	S	S	S	S	S	S	S	S	S	S	S	S	S	S	S	S	S	S	S	S	S	S	S	S	S	S	S	S	S	S	S	S	S	S	S	S	S	S	S	S	S	S	S	S	S	S	S	S	S	S	S	S	S	S	S	S	S	S	S	S	S	S	S	S	S	S	S	S	S	S	S	S	S	S	S	S	S	S	M	W	W	W	W	W	W	W	W	W	W						
W	W	W	W	W	W	W	W	W	W	W	W	W	S	S	S	S	S	S	S	S	S	S	S	S	S	S	S	S	S	S	S	S	S	S	S	S	S	S	S	S	S	S	S	S	S	S	S	S	S	S	S	S	S	S	S	S	S	S	S	S	S	S	S	S	S	S	S	S	S	S	S	S	S	S	S	S	S	S	S	S	S	S	S	S	S	S	S	S	S	S	S	S	S	S	S	S	S	S	S	S	S	S	S	S	S	S	S	W	W	W	W	W	W	W	W	W	W						
W	W	W	W	W	W	W	W	W	W	W	W	W	W	S	S	S	S	S	S	S	S	S	S	S	S	S	S	S	S	S	S	S	S	S	S	S	S	S	S	S	S	S	S	S	S	S	S	S	S	S	S	S	S	S	S	S	S	S	S	S	S	S	S	S	S	S	S	S	S	S	S	S	S	S	S	S	S	S	S	S	S	S	S	S	S	S	S	S	S	S	S	S	S	S	S	S	S	S	S	S	S	S	S	S	S	S	S	W	W	W	W	W	W	W	W	W	W						
W	W	W	W	W	W	W	W	W	W	W	W	W	W	S	S	S	S	S	S	S	S	S	S	S	S	S	S	S	S	S	S	S	S	S	S	S	S	S	S	S	S	S	S	S	S	S	S	S	S	S	S	S	S	S	S	S	S	S	S	S	S	S	S	S	S	S	S	S	S	S	S	S	S	S	S	S	S	S	S	S	S	S	S	S	S	S	S	S	S	S	S	S	S	S	S	S	S	S	S	S	S	S	S	S	S	S	S	W	W	W	W	W	W	W	W	W	W						
W	W	W	W	W	W	W	W	W	W	W	W	W	W	W	S	S	S	S	S	S	S	S	S	S	S	S	S	S	S	S	S	S	S	S	S	S	S	S	S	S	S	S	S	S	S	S	S	S	S	S	S	S	S	S	S	S	S	S	S	S	S	S	S	S	S	S	S	S	S	S	S	S	S	S	S	S	S	S	S	S	S	S	S	S	S	S	S	S	S	S	S	S	S	S	S	S	S	S	S	S	S	S	S	S	S	S	W	W	W	W	W	W	W	W	W	W	W						
W	W	W	W	W	W	W	W	W	W	W	W	W	W	W	W	W	S	S	S	S	S	S	S	S	S	S	S	S	S	S	S	S	S	S	S	S	S	S	S	S	S	S	S	S	S	S	S	S	S	S	S	S	S	S	S	S	S	S	S	S	S	S	S	S	S	S	S	S	S	S	S	S	S	S	S	S	S	S	S	S	S	S	S	S	S	S	S	S	S	S	S	S	S	S	S	S	S	S	S	S	S	S	S	S	S	S	W	W	W	W	W	W	W	W	W	W	W						
W	W	W	W	W	W	W	W	W	W	W	W	W	W	W	W	W	W	W	W	S	S	S	S	S	S	S	S	S	S	S	S	S	S	S	S	S	S	S	S	S	S	S	S	S	S	S	S	S	S	S	S	S	S	S	S	S	S	S	S	S	S	S	S	S	S	S	S	S	S	S	S	S	S	S	S	S	S	S	S	S	S	S	S	S	S	S	S	S	S	S	S	S	S	S	S	S	S	S	S	S	S	S	S	S	S	W	W	W	W	W	W	W	W	W	W	W	W						
W	W	W	W	W	W	W	W	W	W	W	W	W	W	W	W	W	W	W	W	W	W	W	W	S	S	S	S	S	S	S	S	S	S	S	S	S	S	S	S	S	S	S	S	S	S	S	S	S	S	S	S	S	S	S	S	S	S	S	S	S	S	S	S	S	S	S	S	S	S	S	S	S	S	S	S	S	S	S	S	S	S	S	S	S	S	S	S	S	S	S	S	S	S	S	S	S	S	S	S	S	S	S	S	W	W	W	W	W	W	W	W	W	W	W	W	W	W						
W	W	W	W	W	W	W	W	W	W	W	W	W	W	W	W	W	W	W	W	W	W	W	W	W	W	W	W	W	W	W	W	W	W	W	W	W	W	W	W	W	W	W	W	W	W	W	W	W	W	W	W	W	W	W	W	W	W	W	W	W	W	W	W	W	W	W	W	W	W	W	W	W	W	W	W	W	W	W	W	W	W	W	W	W	W	W	W	W	W	W	W	W	W	W	W	W	W	W	W	W	W	W	W	W	W	W	W	W	W	W	W	W	W	W	W	W	W						
W	W	W	W	W	W	W	W	W	W	W	W	W	W	W	W	W	W	W	W	W	W	W	W	W	W	W	W	W	W	W	W	W	W	W	W	W	W	W	W	W	W	W	W	W	W	W	W	W	W	W	W	W	W	W	W	W	W	W	W	W	W	W	W	W	W	W	W	W	W	W	W	W	W	W	W	W	W	W	W	W	W	W	W	W	W	W	W	W	W	W	W	W	W	W	W	W	W	W	W	W	W	W	W	W	W	W	W	W	W	W	W	W	W	W	W	W	W						
W	W	W	W	W	W	W	W	W	W	W	W	W	W	W	W	W	W	W	W	W	W	W	W	W	W	W	W	W	W	W	W	W	W	W	W	W	W	W	W	W	W	W	W	W	W	W	W	W	W	W	W	W	W	W	W	W	W	W	W	W	W	W	W	W	W	W	W	W	W	W	W	W	W	W	W	W	W	W	W	W	W	W	W	W	W	W	W	W	W	W	W	W	W	W	W	W	W	W	W	W	W	W	W	W	W	W	W	W	W	W	W	W	W	W	W	W	W						
